99WWW9999
99WFW9999
99W0WWWW9
WWWB0BFW9
WF0BSWWW9
WWWWBW999
999WFW999
999WWW999